:	ー
w	、
z	あん
e	。
q	あい
[	「
]	」
~	〜
a	あ
nw	ぼう
nz	ばん
ne	べい
nq	ばい
na	ば
nn	っ	n
nd	べ
ng	び
nc	べん
nv	ぶん
nlw	びょう
nlz	びゃん
nle	びぇい
nlq	びゃい
nla	びゃ
nld	びぇ
nlg	びぃ
nlc	びぇん
nlv	びゅん
nls	びょ
nlr	びゅう
nlx	びょん
nlf	びゅ
nlb	びぃん
nlt	びぃい
ns	ぼ
nr	ぶう
nx	ぼん
nf	ぶ
nb	びん
nt	びい
iw	こう
iw	こう
iz	かん
iz	かん
ie	けい
ie	けい
iq	かい
iq	かい
ia	か
ii	っ	i
id	け
ig	き
ic	けん
ic	けん
iv	くん
iv	くん
ilw	きょう
ilz	きゃん
ile	きぇい
ilq	きゃい
ila	きゃ
ild	きぇ
ilg	きぃ
ilc	きぇん
ilv	きゅん
ils	きょ
ilr	きゅう
ilx	きょん
ilf	きゅ
ilb	きぃん
ilt	きぃい
is	こ
ir	くう
ir	くう
ix	こん
ix	こん
if	く
ib	きん
ib	きん
it	きい
it	きい
hw	どう
hz	だん
he	でい
hq	だい
ha	だ
hh	っ	h
hd	で
hjg	でぃ
hjb	でぃん
hjt	でぃい
hg	ぢ
hc	でん
hv	づん
hlw	ぢょう
hlz	ぢゃん
hle	ぢぇい
hlq	ぢゃい
hla	ぢゃ
hld	ぢぇ
hlg	ぢぃ
hlc	ぢぇん
hlv	ぢゅん
hls	ぢょ
hlr	ぢゅう
hlx	ぢょん
hlf	ぢゅ
hlb	ぢぃん
hlt	ぢぃい
hs	ど
hr	づう
hx	どん
hf	づ
hb	ぢん
ht	ぢい
d	え
yw	ふぉう
yz	ふぁん
ye	ふぇい
yq	ふぁい
ya	ふぁ
yd	ふぇ
yy	っ	y
yg	ふぃ
yc	ふぇん
yv	ふゅん
ys	ふぉ
yr	ふう
yx	ふぉん
yf	ふゅ
yb	ふぃん
yt	ふぃい
uw	ごう
uz	がん
ue	げい
uq	がい
ua	が
ud	げ
uu	っ	u
ug	ぎ
uc	げん
uv	ぐん
ulw	ぎょう
ulz	ぎゃん
ule	ぎぇい
ulq	ぎゃい
ula	ぎゃ
uld	ぎぇ
ulg	ぎぃ
ulc	ぎぇん
ulv	ぎゅん
uls	ぎょ
ulr	ぎゅう
ulx	ぎょん
ulf	ぎゅ
ulb	ぎぃん
ult	ぎぃい
us	ご
ur	ぐう
ux	ごん
uf	ぐ
ub	ぎん
ut	ぎい
jw	ほう
jz	はん
je	へい
jq	はい
ja	は
jd	へ
jj	っ	j
jg	ひ
jc	へん
jv	ふん
jlw	ひょう
jlz	ひゃん
jle	ひぇい
jlq	ひゃい
jla	ひゃ
jld	ひぇ
jlg	ひぃ
jlc	ひぇん
jlv	ひゅん
jls	ひょ
jlr	ひゅう
jlx	ひょん
jlf	ひゅ
jlb	ひぃん
jlt	ひぃい
js	ほ
jr	ふう
jx	ほん
jf	ふ
jb	ひん
jt	ひい
g	い
c	えん
v	うん
pw	ぽう
pz	ぱん
pe	ぺい
pq	ぱい
pa	ぱ
pd	ぺ
pjw	ぴょう
pjz	ぴゃん
pje	ぴぇい
pjq	ぴゃい
pja	ぴゃ
pjd	ぴぇ
pjg	ぴぃ
pjc	ぴぇん
pjv	ぴゅん
pjs	ぴょ
pjr	ぴゅう
pjx	ぴょん
pjf	ぴゅ
pjb	ぴぃん
pjt	ぴぃい
pg	ぴ
pc	ぺん
pv	ぷん
pp	っ	p
ps	ぽ
pr	ぷう
px	ぽん
pf	ぷ
pb	ぴん
pt	ぴい
mw	もう
mz	まん
me	めい
mq	まい
ma	ま
md	め
mg	み
mc	めん
mv	むん
mm	っ	m
mlw	みょう
mlz	みゃん
mle	みぇい
mlq	みゃい
mla	みゃ
mld	みぇ
mlg	みぃ
mlc	みぇん
mlv	みゅん
mls	みょ
mlr	みゅう
mlx	みょん
mlf	みゅ
mlb	みぃん
mlt	みぃい
ms	も
mr	むう
mx	もん
mf	む
mb	みん
mt	みい
l	ん
lw	のう
lz	なん
le	ねい
lq	ない
la	な
ld	ね
ljw	にょう
ljz	にゃん
lje	にぇい
ljq	にゃい
lja	にゃ
ljd	にぇ
ljg	にぃ
ljc	にぇん
ljv	にゅん
ljs	にょ
ljr	にゅう
ljx	にょん
ljf	にゅ
ljb	にぃん
ljt	にぃい
lg	に
lc	ねん
lv	ぬん
ll	ん
ls	の
lr	ぬう
lx	のん
lf	ぬ
lb	にん
lt	にい
s	お
r	うう
x	おん
ow	ろう
oz	らん
oe	れい
oq	らい
oa	ら
od	れ
ojw	りょう
ojz	りゃん
oje	りぇい
ojq	りゃい
oja	りゃ
ojd	りぇ
ojg	りぃ
ojc	りぇん
ojv	りゅん
ojs	りょ
ojr	りゅう
ojx	りょん
ojf	りゅ
ojb	りぃん
ojt	りぃい
og	り
oc	れん
ov	るん
os	ろ
or	るう
ox	ろん
oo	っ	o
of	る
ob	りん
ot	りい
;w	そう
;z	さん
;e	せい
;q	さい
;a	さ
;d	せ
;jw	しょう
;jz	しゃん
;je	しぇい
;jq	しゃい
;ja	しゃ
;jd	しぇ
;jg	しぃ
;jc	しぇん
;jv	しゅん
;js	しょ
;jr	しゅう
;jx	しょん
;jf	しゅ
;jb	しぃん
;jt	しぃい
;g	し
;c	せん
;v	すん
;s	そ
;r	すう
;x	そん
;;	っ	;
;f	す
;b	しん
;t	しい
kw	とう
kz	たん
ke	てい
kq	たい
ka	た
kd	て
kjw	てょう
kjz	てゃん
kje	てぇい
kjq	てゃい
kja	てゃ
kjd	てぇ
kjg	てぃ
kjc	てぇん
kjv	とぅん
kjs	てょ
kjr	とぅう
kjx	てょん
kjf	とぅ
kjb	てぃん
kjt	てぃい
kg	ち
kc	てん
kv	つん
klw	ちょう
klz	ちゃん
kle	ちぇい
klq	ちゃい
kla	ちゃ
kld	ちぇ
klg	ちぃ
klc	ちぇん
klv	ちゅん
kls	ちょ
klr	ちゅう
klx	ちょん
klf	ちゅ
klb	ちぃん
klt	ちぃい
ks	と
kr	つう
kx	とん
kk	っ	k
kf	つ
kb	ちん
kt	ちい
f	う
.w	ヴぉう
.z	ヴぁん
.e	ヴぇい
.q	ヴぁい
.a	ゔぁ
.d	ゔぇ
.g	ゔぃ
.c	ヴぇん
.v	ヴん
.s	ゔぉ
.r	ヴう
.x	ヴぉん
.f	ゔ
..	っ	.
.b	ヴぃん
.t	ヴぃい
,w	をう
,z	わん
,e	うぇい
,q	わい
,a	わ
,d	うぇ
,g	うぃ
,c	うぇん
,v	ぅん
,la	うぁ
,ld	うぇ
,lg	うぃ
,ls	うぉ
,lf	う
,s	を
,r	ぅう
,x	をん
,,	っ	,
,,,	,	,,
,b	うぃん
,t	うぃい
,td	ゑ
,tg	ゐ
b	いん
ba	ぁ
bd	ぇ
bg	ぃ
bs	ぉ
bf	ぅ
b,a	ゎ
bta	ゃ
btd	ゅ
bts	ょ
t	いい
tw	よう
tz	やん
te	ゆう
tq	やい
ta	や
td	ゆ
tc	ゆん
ts	よ
tx	よん
tf	ゆ
/w	ぞう
/z	ざん
/e	ぜい
/q	ざい
/a	ざ
/d	ぜ
/jw	じょう
/jz	じゃん
/je	じぇい
/jq	じゃい
/ja	じゃ
/jd	じぇ
/jg	じぃ
/jc	じぇん
/jv	じゅん
/js	じょ
/jr	じゅう
/jx	じょん
/jf	じゅ
/jb	じぃん
/jt	じぃん
/g	じ
/c	ぜん
/v	ずん
/s	ぞ
/r	ずう
/x	ぞん
/f	ず
/b	じん
/t	じい
//	っ	/
hja	でゃ
hjg	でぃ
hjf	でゅ
hjd	でぇ
hjs	でょ
hjq	でゃい
hjq	でぃい
hjr	でゅう
hje	でぇい
hjw	でょお
hjz	でゃん
hjb	でぃん
hjv	でゅん
hjc	でぇん
hjx	でょん
